OOOOXXOOOOOOXOX
OXXOOOOXXOXOXOX
OOOOXXOOXOOOOOX
XXXOXXOXXOXXOOX
XOXOXXOOOOXXXOX
XOXOXXOXOXXOOOX
XOXOOOOXOXXOXXX
XOXXOXOXOXXOOOX
XOOOOXOXXXXXXOX
XXXXOXXOOOOOXOX
XOOOOOOOXXXOXOX
OOXXXXXOXXXOXXX
XOXXXXXOOOXOOXX
XOXXXXXXXOOOXXX
OOOOOOOOOOXOOOO